Destructive harvest 150 DAP (April 2008)
9 replicates from each treatment i.e. temperature x CO2 x water x species

For further information relating to plant growing conditions and treatments, refer to experimental text file

Based on the file "GH_Euc TxCO2xwater 2007-08_April08Harvest.csv"

Data owner: David Tissue
Personelle who collected the data: David Tissue, Oula Ghannoum, Nathan Phillips, Renee Smith, Renee Attard, Roslyn Woodfield
Personelle who worked on data set: Oula Ghannoum, Renee Smith, Renee Attard

Publications: Ghannoum O, Phillips NG, Conroy JP, Smith RA, Attard RD, Woodfield R, Logan BA, Lewis JD, Tissue DT (2010) Exposure to preindustrial, current and future atmospheric CO2 and temperature differentially affects growth and photosynthesis in Eucalyptus. Global Change Biology 16, 303-319



Variables

Species: Eucalyptus species
CO2: carbon dioxide treatment (units:  µL L-1 CO2)
Temp: air temperature treatment
Water: water treatment
Potnum: pot number
LeafDW: leaf dry weight (units: g)
StemDW: stem dry weight (units: g)
RootDW: root dry weight (units: g)
RootShoot: Root to shoot ratio
LMA: leaf mass per unit area (units: g m-2)
LA: leaf area (units: cm2)
Leafnum: number of leaves
LAR: leaf area ratio (m2 kg-1)
Basaldia1: basal diameter in one direction (units: mm)
Basaldia2: basal diameter, perpendicular to the first measure (units: mm)
Tipdia1: main stem tip diameter in one direction (units: mm)
Tipdia2: main stem tip diameter, perpendicular to the first measure (units: mm)
Height: main stem height (units: cm)
Branchnum: number of branches
Mainstemnum: number of main stems, or leaders coming from stem base
Primbranchnum: number of primary branches
Secbranchnum: number of secondary branches
Tertbranchnum: number of tertiary branches
